R 1920 1080
NO ./texture_xpm/WALL1.xpm
SO ./texture_xpm/WALL1.xpm
WE ./texture_xpm/WALL1.xpm
EA ./texture_xpm/WALL1.xpm
S ./texture_xpm/WALL1.xpm
F 220,100,0
C 225,30,0

            1111111111111111111111111
            1000000000110000000000001
            1011000001110000002000001
            1001000000010000000001111
111111111111000001111000000000001
100000000011000001111101111111111
11110111111111011100000010001
11110111111111011101010010001
11000000110101011100000010001
1000200000N000001100010000001
10000000000000001101010010001
1100000111010101111101111000111
11110111 1110101 101111010001
11111111 1111111 111111111111