R 1920 1080
NO ./texture_xpm/WALL74.xpm
SO ./texture_xpm/WALL77.xpm
WE ./texture_xpm/WALL32.xpm
EA ./texture_xpm/WALL1.xpm
S ./texture_xpm/1111.xpm
F 220,100,0
C 225,30,0

            1111111111111111111111111
            1000000000110000200000001
            1011000001110000000002001
            1001000000010000020001111
111111111111000001111000000000001
100002002011000001111101111111111
11110111111111011100000010001
11110111111111011101010010001
10000000111101011100000200201
10000000002000011000120100001
1000000000000001101010010001
11E0000200010101111101111000111
1111011111110101 101111010001
11111111 1111111 111111111111