R 1500 1000



NO ./texture_xpm/WALL32.xpm



SO ./texture_xpm/WALL74.xpm
WE ./texture_xpm/WALL82.xpm
EA ./texture_xpm/WALL1.xpm
S ./texture_xpm/barrel.xpm
SS ./texture_xpm/lamp.xpm


F 199,21,133

C 255,20,147

111111111111111111111
11111111111111111111111
111111111111111111111111
11111111110000000000000011
1111111000000000000000000011
11111100000000000000000000011
111110000000000000000000000011
1111000000000000000000000000011
11100000000000000000000000000011
1100000000000000000000000000000111
11000000000000000000000000000000001
110000000000000000000000000000000001
100000000000111111111000000000000001
1000000001111100000001100000000000001
1000000100000000000000110000000000001
10000010000000000000000110000000000001
1000000000000000000000001100000000000011
10000000000000000000000001100000000000001
10000000000000000000000000100000000000001
100000000000000000000000001000000000000001
10000000011111111100000111010000000000001111
1000000011000000000111100011100000000011100011
10000011000011111111001110001000000001110111001
100001100011000000001100100010000011000000111001
10001100110000000000001001100100010011111000001
10001001100000000000000110110100100110000001001
10011001000011111111100011010100001000000000111
1001001000113311111111333311100001111111111001
100011100113331331111113333130100111131113331111
1000001113333133313331133333111011331331331133111
1000000013333111113333133333311101331111133133311
10000000011331133313331333333311113313331331333311
1000000000011111113333333311111011331131113333111
10000000100000011133133111000010001111111111011
100000000111111000001100001110011000000000111
100000000000000000000011111000000111110000011
100000000000000000000000010000000011000011111
10000000000000000000000000000000000010000000011
1000000000000000000000110000011100000100000000111111111111111111
1000000000000000000011100000010010000010000000110000000000011111
1000000000000000011110000000100001000000000000010000000000110001
1000000000000001111000000000100001000000000000010000000000100001
1000000000000000000000000001100000100000000000010000000000100001
100000000000000000000000001111000010000000000011000000000010001111
100000000011111111111111111001000011111111111110000000000010011001
10000000010000000000000011100110011000000000000000020000001101100111
10000000100000000000000010100011001000000000001000000000001111000111
100000001001111111111111100100100011111111110010000000000010010011001
100000001000000000000001000110010001011111110010001111111110010111001
1000000010000000000200010001001000111000000100100110000011100100010011
10000000011000000000000100010010001000000000011010020000011011000110100
100000000001100000000001000100100100000000001100100000001110010011001
10000200000001110111111100010010010011111100010010010001100100100011
100000000000000000000001100010010000100000110010100000000011001001001
1000000000000000000000011001001000010000001001101010000000011101001001
100000000000000000000000100100000001000000101000000000000000111001001
100000000000000200000000100110000001000000000000000000000000001111011
1000000000000000000000001000000000001000000000000000000000000000101
1000000000000000000000001100000000000100000000000000000000000000001
1000000000020000000000000000000000000010000000020000000000000000011
100000000000000000000000011000000000001100000000000000111000000001
10000000000000000000000000110000000000000000000N000001000000000011
10000000000000000000000000011000000000010000000000001000000000011
10000000020000000000000000001100000000001000000000000001111000111
10000000000000000000000000001010000000000100000000010011000001101
10000000000000000000000000001101000000000100000000000010000011011
1000000020000000002000000000010010000000001000000010000000011001
1000000000000000000000000000010001000000000100000100000000100001
1000000000000000000000000000010000111111000010001000111111100001
1000000000000000000000000000010000000001110001010011100000000001
1000000000000000000020000000110000000000111100100111001100000001
1000000200000000000000000000110000000000100100100101100111100001
1000000000000000000000000001110000000000100110101100100000000001
1000002000000000000000000011010002000000100011111000100000000001
1000000000000000000000000110010000000000100000000000100000000001
1000000000000020000000001100010000000000100000000000100000000001
1000000002000000000000001100010000000000100000000000100000000001
1000000000000000000000011000010000000000100000000000100000000001
1000000000000200000000110000010000000000100000000000100000000001
1000000000000000000001100000010000000000100000000000100000000001
1000000000000000000011000000010000000000100000000000100000000001
1111111111111111111111111111111111111111111111111111111111111111