r 1920 1080



no ./texture_xpm/WALL74.xpm



so ./texture_xpm/WALL1.xpm
we ./texture_xpm/WALL76.xpm

ea ./texture_xpm/WALL83.xpm
s ./texture_xpm/1111.xpm
ss ./texture_xpm/sprite.xpm



f 220,100,0

c 225,30,0



            1111111111111111111111111
            1000300000110003000003001
            1011000001110302002000001
            100100000000002000000N001
1111111111110000011100000000000011111
100000000011000001110111101111111
11110111111111011100000010001
11110111111111011101010010001
11000000110101011100000010201
10002000300000001100000010001
10030000003000001101010010001
1100000111010101111101111000111
11110111 1110101 101111010001
11111111 1111111 111111111111